ğŸ–¥ï¸ ğŸ“Œ Comandos Linux mais usados (essenciais)
ğŸ“‚ 1. NavegaÃ§Ã£o e diretÃ³rios
Comando	FunÃ§Ã£o
pwd	Mostra o diretÃ³rio atual
ls	Lista arquivos
ls -l	Lista detalhada
ls -a	Lista incluindo arquivos ocultos
cd pasta	Entra na pasta
cd ..	Volta um nÃ­vel
cd /caminho	Vai para o caminho indicado
mkdir nome	Cria diretÃ³rio
rmdir nome	Remove diretÃ³rio vazio
ğŸ“ 2. ManipulaÃ§Ã£o de arquivos
Comando	FunÃ§Ã£o
touch arquivo	Cria arquivo vazio
cp origem destino	Copia arquivos
mv origem destino	Move ou renomeia
rm arquivo	Remove arquivo
rm -r pasta	Remove pasta e conteÃºdo
cat arquivo	Exibe conteÃºdo
less arquivo	Exibe conteÃºdo paginado
head arquivo	Primeiras linhas
tail arquivo	Ãšltimas linhas
âš™ï¸ 3. Sistema e informaÃ§Ãµes
Comando	FunÃ§Ã£o
uname -a	InformaÃ§Ãµes do sistema
top	Processos em tempo real
htop	Igual ao top (interface melhor)
df -h	EspaÃ§o em disco
du -h	Tamanho de arquivos/pastas
free -h	Uso de memÃ³ria
uptime	Tempo ligado
ğŸ”§ 4. Processos
Comando	FunÃ§Ã£o
ps	Lista processos
ps aux	Lista completa
kill PID	Finaliza processo
kill -9 PID	ForÃ§a finalizaÃ§Ã£o
pkill nome	Mata processos por nome
ğŸŒ 5. Rede
Comando	FunÃ§Ã£o
ping site	Teste de conexÃ£o
ip a	Mostra interfaces
ifconfig	(compatibilidade)
curl URL	Download / teste HTTP
wget URL	Baixar arquivo
ssh usuario@ip	Conectar via SSH
ğŸ“¦ 6. Pacotes (Debian/Ubuntu)
Comando	FunÃ§Ã£o
sudo apt update	Atualiza lista de pacotes
sudo apt upgrade	Atualiza sistema
sudo apt install pacote	Instala
sudo apt remove pacote	Remove
ğŸ” 7. PermissÃµes
Comando	FunÃ§Ã£o
chmod 755 arquivo	Altera permissÃµes
chown usuario:grupo arquivo	Altera dono
sudo	Executa como root
ğŸ“¦ 8. Arquivos compactados
Comando	FunÃ§Ã£o
tar -cvf arq.tar pasta	Criar tar
tar -xvf arq.tar	Extrair tar
tar -czvf arq.tar.gz pasta	Criar tar.gz
tar -xzvf arq.tar.gz	Extrair tar.gz
zip -r arq.zip pasta	Criar zip
unzip arq.zip	Extrair zip
ğŸ§° 9. Outros Ãºteis
Comando	FunÃ§Ã£o
history	Lista histÃ³rico
clear	Limpa tela
man comando	Ajuda do comando
echo texto	Imprime texto
nano arquivo	Editor simples
sudo su	Vira root